1111011111111111
1020001111132211
1010140011141011
1001101001600031
1101101121115151
1220110201022101
1010010101012201
1011004100400171
1111111111110111