1111111111111111111111111111111111111111111111111111111111111111
1600100011100000000019010000050016100010001001100010000101010001
1010101000001101111011001111111010001000100010001000110101000801
1010001911011001900010100010001010111111111111111111000101010001
0011110110010001111110101000100010100000000000000010011101011111
1010000111510100001000111111111010101111111111111010110001010001
1010110000010111101010100000001010101000000000000010010111010101
1000010111110000100010101111101010101011111111111011010101000101
1111010100001110111110101000101510101010000000091010001101111001
1061010001100100100010101910101010101010101111111010100100000011
1010001010010101901010101110101010101010101000000010110111110101
1011111000100001101010100000101010101010101011111110100000000101
1000000110000100101010111111101010101010101010000000101111111101
1011101110110111111010000000001010101010111010111111001000110001
1000100000110000001011111111111010100010000010010000011111000101
1111101110010101011000001000100000111111111111010011010000011101
1000000001000101000016100010101110010001000000010000010101100001
1010111011011111111111111110100011010101011111111111111111001111
1900000101000100000000500000111001000100010000000000000001010001
1110110100110101111111111111190100111111010111111111111101010101
1000001001000101000000000001610010000010010100000000000101001001
1011011100010101011111111101011001011011010101111111110101100101
1091000000110101010000000101001100001000010101000000010101101101
1111115100000101010111110101101911101011115101011111010101000001
1000000111110101010100010101001061001000010101010001010101011111
1010011100000101010101010101010000011111010101010101010101010001
1001010001111101010091010101010101011091010101010101010101010101
1011000101000101011111010101010001010010010100010101010101010101
1011111101010100000000010101000111000100110111110100010001010151
1001000100010111111111110101101000111001000001010011111111011101
1101010111110000000000000191001010000010010100111000005000019001
1001010000011111111111111111011011111100100010000111111111111101
1016011111010000500001000600000010001001001001110000010001000101
1011110001010101110101101111111110100010010110001011010101010101
1000000100000100000100000000500000101190000000100019000100010001
1111111111111111111111111111111111111111111111111111111111111111