1111111111111111
1016441011010001
1011101000010151
1002200011022101
1111011101101101
1071000120001301
1411211101151111
1002211007100001
1111111111111101