1111111111110111
1010201022110061
1042171012000111
1011110050110111
1001110111020001
1105020111411101
1110112010011401
1000111001070011
1011111111111111