1111111001111111
1000000110000001
1000011001100001
1111110000111111
0000000110000000
1111110000111111
1000011001100001
1000000110000001
1111111001111111