1011111111111111
1220110171110401
1211000144013101
1001511111411021
1104001105002211
1121100121010111
1221112101114001
1100010501160171
1111110111111111