1111110111111111
1741000106122061
1100010121021111
1001050141010001
1021111102000100
1410200111101201
1012101400102211
1002100010001071
1111111111111111