1111111111111101
1000001047102201
1411101011101111
1401121000121601
1310522210001141
1110121111212001
1040100101210111
1710010001000001
1111111111111011