1111111111111011
1601102011311211
1104220054471221
1001001111017121
1011011102200101
1221011151111101
1121020100001101
1021122001104001
1011111111111111