1011111111111111
1001120011122711
1100221001221011
1001121100011511
1211101115110011
1001600110111001
1100110000011121
1110200111044001
1111111111111011