1111111111111011
1111113005001221
1041000111100211
1422217005001011
1411111111111001
1001110011000101
1101000100410401
0020012201611111
1111111111111111