1111111111111111
1000111020111011
1210010210110071
1201400100415171
1101041111022171
1001110001111111
1010202100100011
1000131004001000
1101111111111111