1101111111111111
1002011000101031
1101001010002211
1001105016101201
1011111111111141
1221100014101001
1121001010002100
1000011400110201
1111111111111111