1111111111111111
1050112001050111
1210100100012131
1212101111114001
1012200111110151
1010110010011171
0010111050710141
1400122011004001
1111101111111111