1111101111111111
1010001171010001
1000100100050011
1101142011411111
1221001001400201
1121110401111121
1001220100010101
1610210001000201
1111011111111111